44444444444444444
44444444444444444
33333333333333333
33333333333333333
22222222222222222
22222222222222222
11111111111111111
11111111111111111
00000000000000000
00000000000000000
00000000000000000
00000000000000000
00000000000000000
00000000000000000
00000000000000000
00000000000000000
00000000000000000
00000000000000000
00000000000000000
00000000000000000
00000000000000000
00000000000000000