00000000000000000000000000000000
00000000000000000000000000000000
00000000000000000000000000000000
00003333003330033000000000000000
00003333003333333000000000000000
00000000000000000000000000000000
00000033333333333330033333000000
00000030000000000030033333000000
00000030330000330030000000000000
00000030000000000030000000000000
00000030003333000030000000000000
00000030000000000030000000000000
00000033333333333330000000000000
00000000000000000000000000000000
00000000000000000000000000000000
00000000000000000000000000000000
00000000000000000000000000000000
00000000000000000000000000000000
00000000000000000000000000000000
00000000000000000000000000000000
00000000000000000000000000000000
00000000000000000000000000000000